26
15
17 0 0 0 0 0 0 0 0 0 0 0 0 0 0 0 0 0 0 0 0 0 0 0 0 17 
17 0 0 0 0 0 0 0 0 0 0 0 0 0 0 0 0 0 0 0 0 0 0 0 0 17 
17 0 0 0 0 0 0 0 0 0 0 0 0 0 0 0 0 0 0 0 0 0 0 0 0 17 
17 0 0 0 0 0 0 0 0 0 0 0 0 0 0 0 0 0 0 0 0 0 0 0 0 17 
17 0 0 0 0 0 0 0 0 0 0 0 0 0 0 0 0 0 0 0 0 0 0 0 0 17 
17 16 16 16 16 16 16 16 16 16 16 16 16 16 16 16 16 16 16 16 0 0 0 0 0 17 
17 0 0 4 0 0 0 0 0 4 0 0 0 0 0 4 0 0 0 16 16 0 0 0 0 17 
17 0 0 3 0 0 0 0 0 3 0 0 0 0 0 3 0 0 0 0 16 16 0 0 0 17 
17 0 0 3 0 0 0 0 0 3 0 0 0 0 0 3 0 0 0 0 0 16 16 0 0 17 
17 0 0 3 0 0 0 0 0 3 0 0 0 0 0 3 0 0 0 0 0 0 0 0 0 17 
17 0 0 3 0 0 0 0 0 3 0 0 0 0 0 3 0 0 0 0 0 0 0 0 16 17 
17 0 0 2 0 0 0 0 0 2 0 0 0 0 0 2 0 0 0 0 0 0 0 16 16 17 
16 16 16 16 16 16 16 16 16 16 16 16 16 16 16 16 16 16 16 16 0 0 16 16 16 17 
16 0 0 0 0 0 0 0 0 0 0 0 0 0 0 0 0 0 0 0 0 16 16 16 16 17 
16 16 16 16 16 16 16 16 16 0 16 0 16 0 16 16 16 16 16 16 16 16 16 16 16 17 
