58
15
17 4 0 0 0 0 0 0 0 0 0 0 0 0 0 0 0 0 0 0 0 0 0 0 0 0 0 0 0 0 0 0 0 0 0 0 0 0 0 0 0 13 0 0 0 0 13 0 0 0 0 0 0 0 0 0 3 17 
17 4 0 0 0 0 0 0 0 0 0 0 0 0 0 0 0 0 0 0 0 0 0 0 0 0 0 0 0 0 0 0 0 0 0 0 0 0 0 18 19 19 19 19 19 19 19 19 20 0 0 0 0 0 0 0 3 17 
17 4 0 0 0 0 0 0 0 0 0 0 0 0 0 0 0 0 0 0 0 0 0 0 0 0 0 0 0 0 0 0 0 0 0 0 0 0 0 0 0 0 0 0 0 0 0 0 0 0 0 0 0 0 0 0 3 17 
17 4 0 0 0 0 0 0 0 0 0 0 0 0 0 0 0 0 0 10 0 0 0 0 0 0 0 0 0 0 0 0 0 0 0 0 0 0 0 0 0 0 0 0 0 0 0 0 0 0 0 0 0 0 0 0 3 17 
17 4 0 0 0 0 0 0 0 0 0 0 0 0 0 0 0 0 0 18 19 20 0 0 0 0 0 0 0 0 0 0 0 0 0 0 0 0 0 0 0 0 0 0 0 0 0 0 0 0 18 19 19 19 19 19 19 17 
17 4 0 0 0 0 0 0 0 0 12 0 0 0 0 0 0 0 0 0 0 0 0 0 0 0 13 0 0 0 0 0 0 0 0 0 0 0 0 0 0 0 0 0 0 0 0 0 0 0 0 0 0 0 0 0 3 17 
17 4 0 0 0 0 0 0 0 18 20 0 0 0 0 0 0 0 0 0 0 0 0 0 0 0 19 0 0 5 19 6 0 0 0 0 0 0 0 0 0 0 0 0 0 0 0 0 0 0 0 0 0 0 0 0 3 17 
17 4 0 0 0 0 13 0 0 0 0 0 0 0 0 0 0 0 0 0 0 0 0 0 0 0 0 0 0 0 0 0 0 0 0 0 0 0 0 0 0 0 0 0 0 0 12 0 0 0 0 0 0 0 0 0 3 17 
17 4 0 0 0 18 19 20 0 0 0 0 0 0 0 0 0 0 0 0 0 0 0 0 0 0 0 0 0 0 0 0 5 19 6 0 0 0 0 0 0 0 0 0 0 5 16 16 6 0 0 0 0 0 0 0 3 17 
17 4 0 0 0 0 0 0 0 0 0 0 0 0 0 0 0 0 0 0 0 0 0 0 0 0 0 0 0 0 0 0 0 0 0 0 0 0 0 0 0 0 0 0 5 16 17 17 4 0 0 0 0 0 0 0 3 17 
17 5 16 16 6 0 0 0 0 0 0 0 0 0 0 0 11 0 0 0 11 0 0 0 0 0 0 0 0 18 19 20 0 0 0 0 0 0 0 0 0 0 0 5 16 17 17 17 4 0 0 0 0 0 0 0 3 17 
21 16 22 17 16 6 0 0 0 0 0 0 0 0 0 5 16 6 0 5 16 6 0 0 0 0 0 0 0 0 0 0 0 0 0 0 0 0 0 0 0 0 5 16 17 17 17 17 4 0 0 0 0 0 0 0 3 17 
17 17 17 17 17 16 16 16 6 12 0 0 0 0 5 16 17 16 16 16 17 4 0 0 0 0 5 16 6 0 0 0 0 0 0 0 0 0 0 0 0 5 16 17 17 17 17 17 4 0 0 0 0 0 0 0 3 17 
17 17 17 17 17 17 17 17 16 16 6 0 0 0 3 17 17 17 17 17 17 4 0 0 0 5 16 17 4 12 0 0 12 0 0 0 0 0 0 10 5 16 17 17 17 17 17 17 4 0 0 0 0 0 13 0 3 17 
17 17 17 17 17 17 17 17 17 17 4 0 0 0 0 17 17 17 17 17 17 16 16 16 16 16 17 17 16 16 16 16 16 16 6 0 5 16 16 16 16 17 17 17 17 17 17 17 4 0 0 0 0 5 16 16 16 17 
