33
13
24 24 24 24 24 24 24 24 24 24 24 4 0 0 0 0 0 0 0 0 0 0 0 0 0 0 0 0 0 0 0 3 24 
24 24 24 24 24 24 24 24 24 9 7 0 0 0 0 0 0 0 0 0 0 0 0 0 0 0 0 0 0 0 0 18 24 
24 24 24 24 24 24 24 9 7 0 0 0 0 0 0 0 0 0 0 0 0 0 0 18 19 19 19 20 0 0 0 3 24 
24 24 24 24 24 9 7 0 0 0 0 0 0 0 0 0 0 0 0 0 0 0 0 0 0 0 0 0 0 0 0 3 24 
24 24 24 9 7 0 0 0 0 0 0 0 0 0 0 0 0 0 18 20 0 0 0 0 0 0 0 0 0 0 0 3 24 
24 24 9 0 0 0 0 0 0 0 0 0 0 0 0 0 0 0 0 0 0 0 0 0 0 0 0 0 0 0 0 3 24 
24 9 0 0 0 0 0 0 0 0 0 0 0 0 0 0 0 0 0 0 0 0 18 20 0 0 0 0 0 0 0 3 24 
24 4 0 0 0 0 0 0 0 0 0 0 0 0 0 0 0 0 0 0 0 0 0 0 0 0 0 0 0 0 0 3 24 
24 4 0 0 0 0 0 0 0 0 0 0 0 0 0 0 0 0 0 0 0 0 0 0 0 0 0 0 0 0 0 3 24 
24 4 0 0 0 0 0 0 0 0 0 0 0 0 0 0 0 0 5 16 16 6 0 0 0 0 0 0 0 0 0 3 24 
24 4 0 0 0 0 0 0 0 0 11 0 0 0 0 0 10 5 16 17 17 0 0 0 0 0 0 0 0 0 0 3 24 
24 4 0 10 0 0 0 0 5 16 16 16 6 0 0 16 16 16 17 17 17 0 0 0 0 0 0 0 0 0 0 3 24 
21 16 16 16 16 16 16 16 16 17 17 17 0 0 0 17 17 17 17 17 17 0 0 0 0 0 0 0 0 0 5 16 22 
